11111111111111111111
1P00011000C000110001
10000011000001100C01
10010011000000000001
1C000000000011100001
10000000000C00000001
111000110000000C0001
1000000000110000C001
1C000000000000C000E1
11111111111111111111
