11111111111111111111
1000000000C000110001
100P0011000001100C01
10000111000000000001
1C000110000011100001
10000011000C00000001
111000110000000C0001
1000000000110000C001
1C000000000000C000E1
11111111111111111111
