11111111111111111111
1000000000C000110001
100P0011000001100C01
10000111000000000001
1C000110000000000001
10000010000C00000001
111000110000000C0001
1000000000111100C001
1C000011110000C000E1
11111111111111111111
