11111111111111111111
1000CCCCC00000110001
1000CCPCC00001100C01
1000CCCCC00000000001
1C000000000000000001
10000000000C00000001
100000E00000000C0001
1000000000111100C001
1C000011110000C00001
11111111111111111111